guard_choice [*] :=
 1 0   10 0   19 0   28 1   37 1   46 0   55 0   64 0   73 0   82 0   91 0
 2 0   11 0   20 0   29 0   38 0   47 1   56 0   65 0   74 0   83 0   92 1
 3 1   12 0   21 0   30 0   39 0   48 0   57 0   66 1   75 0   84 0   93 1
 4 1   13 0   22 0   31 0   40 1   49 0   58 1   67 0   76 0   85 0   94 0
 5 0   14 0   23 0   32 0   41 0   50 1   59 0   68 0   77 0   86 0
 6 0   15 0   24 0   33 1   42 0   51 0   60 0   69 0   78 0   87 1
 7 0   16 1   25 0   34 0   43 0   52 0   61 0   70 0   79 0   88 0
 8 0   17 0   26 0   35 0   44 0   53 0   62 0   71 0   80 0   89 0
 9 0   18 0   27 1   36 0   45 0   54 1   63 0   72 0   81 0   90 0
;

